000111111111111111000
000144444444444441000
001444444444444444100
001444444444444444100
014444444444444444410
014444442222444444410
133333220000224444441
144444200000002444441
144444200000002444441
144444200000002444441
144444200000002444441
144444200000002444441
144444200000002444441
155555200000002444441
144444200000002444441
144444200000002444441
144444220000224444441
014444442222444444410
014444444444444444410
001444444444444444100
001444444444444444100
000144444444444441000
000111111111111111000




